#############################
#---b----------b-b----------#
#-*----*-#---b--------------#
#---#########---------------#
#---#-----------------------#
#---#-----------------b-----#
#---#-----*------*----------#
#p--#---------------------bm#
#############################
