##########
#--------#
#----p---#
#--*-----#
#-b---b--#
#--------#
#---m----#
##########
